[
  {
    "idx": "0",
    "bias": "fine",
    "maze": [
      "............$",
      ".............",
      "........CcC..",
      ".....###CcC..",
      "....BBb.CCc..",
      "...#BBb..#...",
      "...#bBB..#...",
      "AAA#.....#dDD",
      "AAa.......dDd",
      "aaA..###..DDD",
      ".............",
      ".............",
      "@............"
    ]
  },
  {
    "idx": "0",
    "bias": "coarse",
    "maze": [
      "............$",
      ".............",
      "........CcC..",
      ".....###CcC..",
      "....BBb.CCc..",
      "...#BBb..#...",
      "...#bBB..#...",
      "AAA#.....#...",
      "AAa..........",
      "aaA..###.....",
      "..........dDD",
      "..........dDd",
      "@.........DDD"
    ]
  },
  {
    "idx": "1",
    "bias": "fine",
    "maze": [
      "............$",
      ".............",
      "........CCC..",
      ".....###Ccc..",
      "....BbB.CCc..",
      "...#BbB..#...",
      "...#BBb..#...",
      "AAa#.....#dDd",
      "aAa.......DDd",
      "AAA..###..DDD",
      ".............",
      ".............",
      "@............"
    ]
  },
  {
    "idx": "1",
    "bias": "coarse",
    "maze": [
      "............$",
      ".............",
      "........CCC..",
      ".....###Ccc..",
      "....BbB.CCc..",
      "...#BbB..#...",
      "...#BBb..#...",
      "...#.....#dDd",
      "..........DDd",
      "AAa..###..DDD",
      "aAa..........",
      "AAA..........",
      "@............"
    ]
  },
  {
    "idx": "2",
    "bias": "fine",
    "maze": [
      "............$",
      ".............",
      "........ccC..",
      ".....###CCC..",
      "....bbb.cCC..",
      "aAA#BBB..#...",
      "aAA#BBB..#...",
      "AAa#.....#DdD",
      "..........DdD",
      ".....###..DDd",
      ".............",
      ".............",
      "@............"
    ]
  },
  {
    "idx": "2",
    "bias": "coarse",
    "maze": [
      "............$",
      ".............",
      "........ccC..",
      ".....###CCC..",
      "........cCC..",
      "aAA#bbb..#...",
      "aAA#BBB..#...",
      "AAa#BBB..#DdD",
      "..........DdD",
      ".....###..DDd",
      ".............",
      ".............",
      "@............"
    ]
  },
  {
    "idx": "3",
    "bias": "fine",
    "maze": [
      "............$",
      "..bBB........",
      "..BBb...CcC..",
      "..BBb###CCc..",
      "........CCc..",
      "...#.....#...",
      "...#.....#...",
      "...#.....#dDD",
      "aAA.......DDd",
      "aAa..###..DDd",
      "AAA..........",
      ".............",
      "@............"
    ]
  },
  {
    "idx": "3",
    "bias": "coarse",
    "maze": [
      "bBB.........$",
      "BBb..........",
      "BBb.....CcC..",
      ".....###CCc..",
      "........CCc..",
      "...#.....#...",
      "...#.....#...",
      "...#.....#dDD",
      "aAA.......DDd",
      "aAa..###..DDd",
      "AAA..........",
      ".............",
      "@............"
    ]
  },
  {
    "idx": "4",
    "bias": "fine",
    "maze": [
      "............$",
      ".............",
      "........CCC..",
      "aAA..###CCC..",
      "Aaa.bBB.ccc..",
      "AAA#bBB..#...",
      "...#BbB..#...",
      "...#.....#Ddd",
      "..........DDD",
      ".....###..DDd",
      ".............",
      ".............",
      "@............"
    ]
  },
  {
    "idx": "4",
    "bias": "coarse",
    "maze": [
      "............$",
      ".............",
      ".........CCC.",
      "aAA..###.CCC.",
      "Aaa.bBB..ccc.",
      "AAA#bBB..#...",
      "...#BbB..#...",
      "...#.....#Ddd",
      "..........DDD",
      ".....###..DDd",
      ".............",
      ".............",
      "@............"
    ]
  },
  {
    "idx": "5",
    "bias": "fine",
    "maze": [
      "............$",
      ".............",
      "........cCC..",
      "AAA..###CCc..",
      "aAa.bBB.CcC..",
      "AAa#bBB..#...",
      "...#BbB..#...",
      "...#.....#Ddd",
      "..........DDD",
      ".....###..DDd",
      ".............",
      ".............",
      "@............"
    ]
  },
  {
    "idx": "5",
    "bias": "coarse",
    "maze": [
      "AAA.........$",
      "aAa..........",
      "AAa.....cCC..",
      ".....###CCc..",
      "....bBB.CcC..",
      "...#bBB..#...",
      "...#BbB..#...",
      "...#.....#Ddd",
      "..........DDD",
      ".....###..DDd",
      ".............",
      ".............",
      "@............"
    ]
  },
  {
    "idx": "6",
    "bias": "fine",
    "maze": [
      "............$",
      ".............",
      "..BbB...cCc..",
      "..BBB###CCc..",
      "..bbB...CCC..",
      "...#.....#...",
      "...#.....#...",
      "AAA#.....#...",
      "Aaa.......dDD",
      "aAA..###..DDD",
      "..........ddD",
      ".............",
      "@............"
    ]
  },
  {
    "idx": "6",
    "bias": "coarse",
    "maze": [
      "............$",
      ".............",
      "..BbB...cCc..",
      "..BBB###CCc..",
      "..bbB...CCC..",
      "...#.....#...",
      "...#.....#...",
      "AAA#.....#...",
      "Aaa..........",
      "aAA..###.....",
      "..........dDD",
      "..........DDD",
      "@.........ddD"
    ]
  },
  {
    "idx": "7",
    "bias": "fine",
    "maze": [
      "............$",
      ".............",
      "..BBb........",
      "..bbB###..DDD",
      "..BBB.ccc.DDd",
      "...#..CCC#dDd",
      "...#..CCC#...",
      "...#.....#...",
      "AaA..........",
      "AaA..###.....",
      "aAA..........",
      ".............",
      "@............"
    ]
  },
  {
    "idx": "7",
    "bias": "coarse",
    "maze": [
      "............$",
      ".............",
      "..BBb........",
      "..bbB###..DDD",
      "..BBB.....DDd",
      "...#.....#dDd",
      "...#..ccc#...",
      "...#..CCC#...",
      "AaA...CCC....",
      "AaA..###.....",
      "aAA..........",
      ".............",
      "@............"
    ]
  }
]